"filename", "language", "TypeScript", "TypeScript JSX", "comment", "blank", "total"
"c:\dev\build_buddy_1.2\frontend\src\pages\dashboard-page\DashboardPage.tsx", "TypeScript JSX", 0, -56, -4, -5, -65
"c:\dev\build_buddy_1.2\frontend\src\pages\landing-page\LandingPage.tsx", "TypeScript JSX", 0, -79, -1, -3, -83
"c:\dev\build_buddy_1.2\frontend\src\pages\landing-page\components\FeatureCard.tsx", "TypeScript JSX", 0, -20, -1, -3, -24
"c:\dev\build_buddy_1.2\frontend\src\pages\login-page\LoginPage.tsx", "TypeScript JSX", 0, -10, 0, -2, -12
"c:\dev\build_buddy_1.2\frontend\src\pages\login-page\components\LoginForm.tsx", "TypeScript JSX", 0, -111, -12, -11, -134
"c:\dev\build_buddy_1.2\frontend\src\pages\notes-page\NotesPage.tsx", "TypeScript JSX", 0, -24, -2, -3, -29
"c:\dev\build_buddy_1.2\frontend\src\pages\notes-page\plate\editor.tsx", "TypeScript JSX", 0, -130, -65, -24, -219
"c:\dev\build_buddy_1.2\frontend\src\pages\projects-page\ProjectsPage.tsx", "TypeScript JSX", 0, -42, -2, -5, -49
"c:\dev\build_buddy_1.2\frontend\src\pages\projects-page\components\DueDatePicker.tsx", "TypeScript JSX", 0, -52, 0, -7, -59
"c:\dev\build_buddy_1.2\frontend\src\pages\projects-page\components\ProjectCard.tsx", "TypeScript JSX", 0, -185, -2, -19, -206
"c:\dev\build_buddy_1.2\frontend\src\pages\projects-page\components\ProjectForm.tsx", "TypeScript JSX", 0, -127, 0, -7, -134
"c:\dev\build_buddy_1.2\frontend\src\pages\projects-page\components\StatusTabs.tsx", "TypeScript JSX", 0, -47, 0, -4, -51
"c:\dev\build_buddy_1.2\frontend\src\pages\register-page\RegisterPage.tsx", "TypeScript JSX", 0, -10, 0, -2, -12
"c:\dev\build_buddy_1.2\frontend\src\pages\register-page\components\RegisterForm.tsx", "TypeScript JSX", 0, -144, -3, -7, -154
"c:\dev\build_buddy_1.2\frontend\src\pages\tasks-page\TasksPage.tsx", "TypeScript JSX", 0, -16, -1, -4, -21
"c:\dev\build_buddy_1.2\frontend\src\pages\tasks-page\components\ProjectNameCombobox.tsx", "TypeScript JSX", 0, -87, -7, -8, -102
"c:\dev\build_buddy_1.2\frontend\src\pages\tasks-page\components\ProjectToggleTabs.tsx", "TypeScript JSX", 0, -30, 0, -3, -33
"c:\dev\build_buddy_1.2\frontend\src\pages\tasks-page\components\TaskForm.tsx", "TypeScript JSX", 0, -238, -7, -16, -261
"c:\dev\build_buddy_1.2\frontend\src\pages\tasks-page\components\tasks-table\columns.tsx", "TypeScript JSX", 0, -106, -11, -10, -127
"c:\dev\build_buddy_1.2\frontend\src\pages\tasks-page\components\tasks-table\data-table.tsx", "TypeScript JSX", 0, -179, -15, -14, -208
"c:\dev\build_buddy_1.2\frontend\src\validators\loginSchema.ts", "TypeScript", 5, 0, 0, 2, 7
"c:\dev\build_buddy_1.2\frontend\src\validators\projectSchema.ts", "TypeScript", 29, 0, 0, 3, 32
"c:\dev\build_buddy_1.2\frontend\src\validators\registerSchema.ts", "TypeScript", 12, 0, 2, 2, 16
"c:\dev\build_buddy_1.2\frontend\src\validators\taskSchema.ts", "TypeScript", 30, 0, 0, 2, 32
"Total", "-", 76, -1693, -131, -148, -1896